###                    ####
#   ##################    #
# ####                # # #
# ################### # # #
#                     # # #
##################### # # #
#   ##                # # #
# # ## ### ## ######### # #
# #    #A  ##           # #
# # ## ################ # #
### ##             #### # #
### ############## ## # # #
###             ##B   ### #
###### ######## ####### # #
###### ###              # #
#      ####################
