###                    ####
#   ##################    B
# ####                # # #
# ################### # # #
#                     # # #
##################### # # #
#   ##                # # #
# # ## ### ## ######### # #
# #    #   ##           # #
# # ## ################ # #
### ##             #### # #
### ############## ## # # #
###             ##    ### #
###### ######## ####### # #
###### ###              # #
A      ####################
