###                 #######
#   ###################   #
# ####                # # #
# ################### # # #
#                     # # #
##################### # # #
#   ##                # # #
# # ## ### ## ######### # #
# #    #   ##B#         # #
# # ## ################ # #
### ##             #### # #
### ############## ## # # #
###             ##    # # #
###### ######## ####### # #
###### ####             # #
A      ####################
